111111111111111
1S0010001000001
101010101011101
100010100010001
111010101110101
1000B0001000101
101111101011101
1000B000100B001
111111101111101
100000100000101
101110111110101
100010100000101
101010101111101
100B001000000G1
110111111111111