1111111111111111111
1000000000000000001
1000000000000000001
1000000000000000001
1000000000000000001
1111100000000001111
0000100000000001000
0000100000000001000
0000100000S00001000
0000100000000001000
0000100000000001000
0000100000000001000
0000100000000001000
0000100000000001000
0000111111111111000