11122221111113333111
11122221111113333111
11122221111113333111
11122221111113333111
11122221111113333111
11122221111113333111
11122221111113333111
11122221111113333111
11111111111111111111
11111111100111111111
11111111100111111111
11111111111111111111
11122221111113333111
11122221111113333111
11122221111113333111
11122221111113333111
11122221111113333111
11122221111113333111
11122221111113333111
11515151515151515111