11122221111113333111
10000000000000000001
10000000000000000001
10000000000000000001
10000000000000000004
10000000000000000004
10000000000000000004
10000000000000000004
10000000000000000001
11111000000000011111
NNNN100000000001NNNN
NNNN100000000001NNNN
NNNN100000000001NNNN
NNNN100000000001NNNN
NNNN100000000001NNNN
NNNN100000000001NNNN
NNNN100000000001NNNN
NNNN100000000001NNNN
NNNN100000000001NNNN
NNNN515151515151NNNN