1111111111
1000000001
1111101111
00001B1000
0000101000
0000101000
0000101000
0000101000
00001S1000
0000111000