1111111111
1010001111
1110001111
1110001001
1111111111
1111111111
1000001111
1100001111
1101101001
1111111111