11122221111113333111
10000000000000000001
10000000000000000001
10000000000000000001
10000000000000000004
10000000000000000004
10000000000000000004
10000000000000000004
10000000000000000001
10000000000000000001
10000000000000000001
10000000000000000001
10000000000000000001
10000000000000000001
10000000000000000001
10000000000000000001
10000000000000000001
10000000000000000001
10000000000000000001
11515151515151515111