11122221111113333111
10000000000000000001
10000000000000000004
10000000000000000004
10000000000000000001
11111111000011111111
NNNNNNN100001NNNNNNN
NNNNNNN100001NNNNNNN
NNNNNNN100001NNNNNNN
NNNNNNN100001NNNNNNN
NNNNNNN100001NNNNNNN
NNNNNNN100001NNNNNNN
NNNNNNN100001NNNNNNN
NNNNNNN100001NNNNNNN
NNNNNNN100001NNNNNNN
NNNNNNN100001NNNNNNN
NNNNNNN100001NNNNNNN
NNNNNNN100001NNNNNNN
NNNNNNN100001NNNNNNN
NNNNNNN515151NNNNNNN