NNNNNNNNNNNNNNNNNNNN
NNNN111NNNNNNN111NNN
NNNN101NNNNNNN101NNN
NNNN9f9NNNNNNN909NNN
NNNN101NNNNNNN101NNN
NNNN101NNNNNNN101NNN
NNNN808NNNNNNN8f8NNN
NNNN101NNNNNNN101NNN
NNNN101NNNNNNN101NNN
NNNN101NNNNNNN101NNN
NNNN606NNNNNNN707NNN
NNNN606NNNNNNN707NNN
NNNN606NNNNNNN707NNN
NNNN101NNNNNNN101NNN
NNNN101NNNNNNN101NNN
NNNN101NNNNNNN101NNN
NNNN101NNNNNNN101NNN
NNNN1s1NNNNNNN1s1NNN
NNNN111NNNNNNN111NNN
NNNNNNNNNNNNNNNNNNNN